############################
#            ##            #
# ####       ##       #### #
#   ## ##### ## ##### ##   #
#   ## #####    ##### ##   #
#   ##                ##   #
#   ## ##    ##    ## ##   #
#      ##  ######  ##      #
#      ##    ##    ##      #
#  ##  ###        ###  ##  #
#  ##  #####    #####  ##  #
#  ##  ##          ##  ##  #
# ###  ## ###  ### ##  ### #
# ###  ## #      # ##  ### #
#   #  ## #      # ##  #   #
#   #  ## #      # ##  #   #
### #  ## ######## ##  # ###
#                          #
# #### ####  ##  #### #### #
# #### ####  ##  #### #### #
#   ## ##    ##    ## ##   #
#   ## ##  ######  ## ##   #
##                        ##
##  ##  ####    ####  ##  ##
#   ##  #### ## ####  ##   #
#   ##       ##       ##   #
#  ###### ######### #####  #
#  ###### ######### #####  #
#                          #
############################