###########################
#          #              #
#  ######  #    ########  #
#      #  ####     #      #
#      #           #      #
######                    #
#         ####### #     ###
#  ###  # ####### #     ###
#  #    #         ###   ###
#  #  #####       #     ###
#                 #  #  ###
#  ###               #    #
#    #    ##   ## ######  #
#    #    #     #         #
#         #     #         #
#  #####  #     #  #####  #
#  #      #######      #  #
#  #   #         #     #  #
#      #    ###  #        #
#  #####     #   #####    #
#                         #
##  ###  ######### ###   ##
#     #      #     #      #
#     #  #   #     #   #  #
#        #   #         #  #
#   ######       #######  #
##           #           ##
#   #        #        #   #
#  ####### ##### #######  #
#                         #
###########################