###########################
#      #           #      #
#      #  #######  #      #
#  ### #  #######  # ###  #
#    #               #    #
###  #               #  ###
###  #  # ####### #  #  ###
###  #  #    #    #  #  ###
###     #    #    #     ###
###   #####  #  #####   ###
###  #               #  ###
#    #               #    #
#  ###### ##   ## ######  #
#         #     #         #
#         #     #         #
#  #####  #     #  #####  #
#  #      #######      #  #
#  #                   #  #
#    #####  ###  #####    #
###          #          ###
###          #          ###
###  ######     ######  ###
#    ######     ######    #
#  #        ###        #  #
#  #        ###        #  #
#  #######       #######  #
#          #####          #
#           ###           #
#  #######       #######  #
#                         #
###########################